==================================================
=------------------=======================-------=
=------------------------------------------------=
=---------========================---------------=
=------------------------------------------------=
=-----=-----==--=--=-------------=-------=-------=
=-----=-----==--=--=--=============-----==--===--=
=-----=--=--==--=--=---------------------=--=-=--=
=--------=--==--=--=--==========--========--=-=--=
=--------=----------------------------------=-=--=
=-----=--=----------------------------------=-=--=
=-----=--===================--===============-====
=-----=------------=-------=---------------------=
=-----=------------=-------=====--========-------=
=-----===========--=---------------------=-------=
==========---------=---------==---==-----=========
=-----=--=--====---========----===-------=-------8
=-------------------------=--==---==-----=---=---=
=-----=--=======----------=------------------=---=
==================================================
